..................................................................................................
.                                                                                                .
.                                                                                                .
.                                                                                                .
.                                                                                                .
.                                                                                                .
.                                                                                                .
.                                                                                                .
.                                                                                                .
.        RRRRRRRRRRRRRR   RRRRRRRRRRRRRRRRRRRRRRRRRRRRRRRRRRRRRRRRRRRRRRRRRRRRRRRRRRRRRRR        .
.        R                                                                              R        .
.        R               R    T                                                         R        .
.        R        T          T                                                          R        .
.        R            R                                                                 R        .
.        R                                                                              R        .
.        R                                                                              R        .
.        R                                                                              R        .
.        R                                                                              R        .
.        R                                                                              R        .
.        R                                                                              R        .
.        R                                                                              R        .
.        R                                                                              R        .
.        R                                                                              R        .
.        R                                                                              R        .
.        R                                                                              R        .
.        R                                                                              R        .
.        R                                                                              R        .
.        R                                                                              R        .
.        R                                                                              R        .
.        R                                                                              R        .
.        R                                                                              R        .
.        R                                                                              R        .
.        R                                                                              R        .
.        R                                                                              R        .
.        R                                                                              R        .
.        R                                                                              R        .
.        R                                                                              R        .
.        R                                                                              R        .
.        R                                                                              R        .
.        R                                                                              R        .
.        R                                                                              R        .
.        R                                                                              R        .
.        R                                                                              R        .
.        R                                                                              R        .
.        R                                                                              R        .
.        R                                                                              R        .
.        R                                                                              R        .
.        R                                                                              R        .
.        RRRRRRRRRRRRRRRRRRRRRRRRRRRRRRRRRRRRRRRRRRRRRRRRRRRRRRRRRRRRRRRRRRRRRRRRRRRRRRRR        .
.                                                                                                .
.                                                                                                .
.                                                                                                .
.                                                                                                .
.                                                                                                .
.                                                                                                .
.                                                                                                .
.                                                                                                .
..................................................................................................