TTTTTTTTTTTTTTTT
T  H  T T     RT
T R      H   R T
T   T  H   R T T
THT RTR  TH    T
T      RT     RT
T H  RH  HTRH HT
T    TRH       T
TTTTTTTT.TTTTTTT