RRRRRRRRRRRRRR.RRRRRRRRRRRRRRRRRRRRRRRRRRRRRRRRRRRRRRRRRRRRRRRRRRRRRRRRRRRRRRRRR
R                                                                              R
R                                                                              R
R                                                                              R
R                                                                              R
R                                                                              R
R                                                                              R
R                                                                              R
R                                                                              R
R                                                                              R
R                                                                              R
R                                                                              R
R                                                                              R
R                                                                              R
R                                                                              R
R                                                                              R
R                                                                              R
R                                                                              R
R                                                                              R
R                                                                              R
R                                                                              R
R                                                                              R
R                                                                              R
R                                                                              R
R                                                                              R
R                                                                              R
R                                                                              R
R                                                                              R
R                                                                              R
R                                                                              R
R                                                                              R
R                                                                              R
R                                                                              R
R                                                                              R
R                                                                              R
R                                                                              R
R                                                                              R
R                                                                              R
R                                                                              R
RRRRRRRRRRRRRRRRRRRRRRRRRRRRRRRRRRRRRRRRRRRRRRRRRRRRRRRRRRRRRRRRRRRRRRRRRRRRRRRR